1111111111111111
1000000000000001
1000000000000001
1000000000000001
1000000000000001
1000003000000001
1000333000000201
1000003000000201
1000003222222201
1000003000020001
1000003000020001
1000003000020001
1000000000020001
1000000000000001
1000000000000001
1111111111111111
